409000001
001070050
300082000
050000420
400006800
028510607
030601040
000900570
804003000