750000000
003040021
400100075
000078000
060409010
020500000
000080000
100007064
000003002