002004830
003060902
560009014
000300508
020000040
907005000
380500029
109020400
054800600