000600003
090000001
200004960
000000100
300070000
070800490
000000006
005002000
030400780